
 #  E  #  #  #  #  #  #  #  #  #  # 
 #                                # 
 #                                # 
 #  #  #  #                       # 
 #                 !              # 
 #                                # 
 #                                # 
 #        *                       # 
 #                                # 
 #                                # 
 #                                # 
 #  #  #  #  #  #  #  #  #  #  X  # 
